####################
# 󱌂 웃             #
#                  #
#                  #
#                  #
#                  #
#                  #
#                  #
#                  #
###########      ###
