####################
# b a  c           #
#                  #
#                  #
#                  q
#                   
#                  #
#                  #
#                  #
############e   ####
