##o   #################################o   #######################
#                                                                #
#                      u         u        u                      #
#             u                                    u             #
#                                                          u     #
#                                                                #
#             #####                             #####            #
#             #                                     #            #
#        1    #   p                             p   #            #
o             #                                     #            o
              #####                             #####             
#                                                         u      #
#             u                                    u             #
#                      u         u        u                      #
#                                                             ####
#                                #                               #
#                                #                     t         #
#                2             2 #  2            2               #
#                                #                    ############
#######################################################
